■■■■■■■■■■■■■■■■■■■■■■■■■■■■■
█             ■             █
█  ■■■  ■■■■  ■  ■■■■  ■■■  █
█                           █
█  ■■■  ■  ■■■■■■■  ■  ■■■  █
█       ■     ■     ■       █
█■■■■■  ■■■■  ■  ■■■■  ■■■■■█
     ■  ■           ■  ■     
█■■■■■  ■  ■■   ■■  ■  ■■■■■█
           ■     ■           
           ■     ■           
█■■■■■  ■  ■■■■■■■  ■  ■■■■■█
     ■  ■           ■  ■     
█■■■■■  ■  ■■■■■■■  ■  ■■■■■█
█             ■             █
█  ■■■  ■■■■  ■  ■■■■  ■■■  █
█    ■                 ■    █
█■■  ■  ■  ■■■■■■■  ■  ■  ■■█
█       ■     ■     ■       █
█  ■■■■■■■■   ■  ■■■■■■■■■  █
█                           █
■■■■■■■■■■■■■■■■■■■■■■■■■■■■■